R 1920 1080
NO ./path_to_the_north_texture
SO ./path_to_the_south_texture
WE ./path_to_the_west_texture
EA ./path_to_the_east_texture
S ./path_to_the_sprite_texture
F 	49,140,231
C 49,140,231
        1111111111111111111111111
        1000000000110000000000001
        1011000001110000002000001
        1001000000000000000000001
111111111011000001110000000000001
100000000011000001110111111111111
11110111111111011100000010001
1111011111111100001010010001
1100000011010100000000010001
100020000010000000000000001
1E000000000100000001010010001
1100000111010101111101111000111
11110111 1110101 101111010001
11111111 1111111 111111111111