R                   1920 1080

NO texture/eagle.xpm



SO texture/wood.xpm
WE texture/nazi.xpm
EA texture/redbrick.xpm
S  texture/barrel.xpm
C 0,255,255
F 15,100,1




        1111111111111111111111111
        10000101000000000000000001
        1000000000000000002000001 
        1000000000000000000000001
111111111000000000000000000000001
100000000000000000000000000011111
10000000000000000000000000001
10000000000000000000000000001
10000000000000000000000000001
10000000000000000000000000001     
1000000000000000N000000000001
1000000010000000100000000000111
11111111 1111111 111111111111
10000001 1000001 100000000001