R   1000 500

NO texture/eagle.xpm



SO texture/wood.xpm

E texture/redbrick.xpm
S  texture/barrel.xpm
C    0,255,255
F      15,100,1
W Texture/nazi.xpm

        1111111111111111111111111
        1000000000000000001000001
        10000000000000000121000001 
        1000000000000000001000001 
111111111000000000000000000000001
100000000000000000000000000011111
100000000000000000001100000001
1000000000000000000N1 10000001
10000000000000000000111000001
100000000000000002000000000001     
10000000000000000000000000001
100000001000000010000000000111
10000001 1000001 100000000001
11111111 1111111 1111