R                   1920 1080

NO texture/eagle.xpm



SO texture/wood.xpm
WE texture/nazi.xpm
EA texture/redbrick.xpm
S  texture/barrel.xpm
C 0,255,255
F 15,100,1




111111111111111111111
100000000000002000001
100000000000000200001
10E000000000000002001
100000000000000000001
111111111111111111111