R                   1500 1500
NO texture/eagle.xpm
SO texture/wood.xpm
WE texture/nazi.xpm
S  texture/barrel.xpm
C 0,255,255
F 15,100,1
EA texture/redbrick.xpm




        1111111111111111111111111
        1000000000000000000000001
        1000000000000000000000001 
        1000000000000000000000001 
111111111000000000000000000000001
100000000000000020000000000011111
10000000002000000002000000001
10000000000000000000000000001
100000000000000N0000000000001
10000000000000000000000000001     
10000000000000000000000000001
1000000010000000100000000000111
10000001 1000001 100000000001
11111111 1111111111111111111