R                    500 500

NO texture/eagle.xpm



SO texture/wood.xpm
WE texture/nazi.xpm
EA texture/redbrick.xpm
S  texture/barrel.xpm
C 0,255,255
F 15,100,1


        1111111111 111111111111111
        1000000000000000001000001
        100000000000000001 1000001 
        1000000000000000001000001 
111111111000000000000000000000001
100000000000000000000000000011111
10000000000000000000000000001
10000000000000000000000000001
10000000000000000000000000001
10000000000000000000000000001     
10000000000000000000000000001
10000000100000001000000000N0111
10000001 1000001 100000000001
11111111 1111111 111111111111