R                   500 1080

NO texture/eagle.xpm



SO texture/wood.xpm
WE texture/nazi.xpm
EA texture/redbrick.xpm
S  texture/barrel.xpm
C 0,255,255
F 15,100,1




1111111111111111111111
1000000000000000000201
1E00000002000000000001
1000000000000000020001
1000000000000020000001
1111111111111111111111