R                   1920 1080

NO texture/eagle.xpm



SO texture/wood.xpm
WE texture/nazi.xpm
EA texture/redbrick.xpm
S  texture/barrel.xpm
C 0,255,255
F 15,100,1

11111111111111111111111111
10000000000002000000000001
10000000000000000000000001
10002000000000000000002001
10000000000000000000000001
100000000000N0000000000001
11111111111111111111111111