R                   500 1080

NO texture/eagle.xpm



SO texture/wood.xpm
WE texture/nazi.xpm
EA texture/redbrick.xpm
S  texture/barrel.xpm
C 0,255,255
F 15,100,1




111111111111111111 
10000000000000000001
10000000S000000001
100000001000000001
100000000000020001
100000001000000001
100000000000000001
10000000200 0000001
100000001000000001
100000000000002001
100000001000000001
111111111111111111