R     1000000000 1100000001

NO texture/eagle.xpm
SO texture/wood.xpm
WE texture/nazi.xpm
S texture/barrel.xpm

C 0,255,11
F 0,0,11
EA texture/redbrick.xpm

        1111111111111111111111111
        1000000000000000000000001
        1000000000000000002000001 
        1000000000000000000000001 
111111111000000000000000000000001
100000000000000000000000000011111
10000000000000000000000000001
10000000000000000000000000001
100000000N0000000000000000001
10000000000000000000000000001     
10000000000000000000000000001
1000000010000000100000000000111
10000001 1000001 100000000001
11111111 1111111 111111111111