R     9 9

NO texture/eagle.xpm
SO texture/wood .xpm
WE texture/nazi.xpm
S texture/barrel.xpm

C 0,255,11
F 0,0,11
EA texture/redbrick.xpm

111111111111
100000020001
100000212001
1N0000000021
111111111111