R     400 900

NO texture/eagle.xpm
SO texture/wood .xpm
WE texture/nazi.xpm
S texture/barrel.xpm

C 0,255,11
F 0,0,11
EA texture/redbrick.xpm

11111111111
100000000001
100000000001
10000N000021
111111111111