R 700 700
NO texture/colorstone.xpm
SO texture/eagle.xpm
WE texture/wood.xpm
EA texture/nazi.xpm
S texture/barrel.xpm
C 0,0,0
F 0,0,0
                 1111111           11111111111
                100S0001          1000000000001  
               10000001           1000111100001
              10000001            11111  100001 
             10000001                    100001
            10000001                    100001
           10000001  1111              100001
          10000001  10001             100001
         1000000111110001111         100001
         1000000000000000001        100001
         1000000000000000001       1000001
         1111111111100001111      1000000111111
                   100001         1000000000001
                   100001         1111111110001
                   100001                 10001
                   1000011111111111111111110001
                   1000000000000000000000000001
                   1000000000000000000000000001
                   1111111111111111111111111111
