R 700 700
NO texture/colorstone.xpm
SO texture/eagle.xpm
WE texture/wood.xpm
EA texture/nazi.xpm
S texture/barrel.xpm
C 0,0,0
F 0,0,0

11111111111111111         11111111111111111   11111111111111111   11111111111111111
1E000000000000001         10000000000000001   10000000000000001   10000000000000001
10000000000000001         10000000000000001   10000000000000001   10000000000000001
11111111111111001         11111111111111001   11111111111111001   11111111111111001
             1001                      1001                1001                1001
             1001                      1001                1001                1001
             1001                      1001                1001                1001
             1001         11111111111111001   11111111111111001                1001
             1001         10000000000000001   10000000000000001                1001
             1001         10000000000000001   10000000000000001                1001
             1001         11111111111111001   11111111111111001                1001
             1001                      1001                1001                1001
             1001                      1001                1001                1001
             1001                      1001                1001                1001
             1001         11111111111111001   11111111111111001                1001
             1001         10000000000000001   10000000000000001                1001
             1001         10000000000000001   10000000000000001                1001
      11111111001111111   11111111111111001   11111111111111001                1001
      11111111001111111   11111111111111001   11111111111111001                1001
      11111111001111111   11111111111111001   11111111111111001                1001
       111111000111111111111111111111111001111111111111111110011111111111111111001 
        1000000000000000000000000000000000000000000000000000000000000000000000001  
         10000000002222222222222222222222222222222222222222222222222222220000001   
          111111111111111111111111111111111111111111111111111111111111111111111    